3
03:00-03:50
18:00-19:00
03:50-04:30
2
11:00-12:00
10:00-13:00
0